{
  "level": 1,
  "rows": 15,
  "cols": 15,
  "start_money": 150,
  "plateau_threshold": 0.8,
  "server_radius": 2,
  "waves": [
    {
      "wave_number": 1,
      "enemies": ["trojan", "trojan", "spyware"],
      "interval_seconds": 3.0
    },
    {
      "wave_number": 2,
      "enemies": ["trojan", "worm", "worm", "spyware"],
      "interval_seconds": 2.5
    },
    {
      "wave_number": 3,
      "enemies": ["trojan", "trojan", "worm", "spyware", "ransomware"],
      "interval_seconds": 2.0
    }
  ],
  "grid": [
    [0, 4, 0, 0, 0, 0, 0, 4, 0, 0, 0, 0, 0, 0, 0],
    [0, 1, 1, 1, 1, 1, 1, 1, 1, 1, 1, 1, 1, 1, 0],
    [0, 0, 0, 0, 0, 0, 0, 0, 0, 0, 0, 0, 0, 1, 0],
    [0, 0, 0, 0, 0, 0, 0, 0, 0, 0, 0, 0, 0, 1, 0],
    [0, 0, 0, 0, 0, 0, 0, 0, 0, 0, 0, 0, 0, 1, 0],
    [0, 0, 0, 0, 0, 1, 1, 1, 1, 1, 1, 1, 1, 1, 0],
    [0, 0, 0, 0, 0, 1, 0, 0, 0, 0, 0, 0, 0, 0, 0],
    [0, 0, 0, 0, 0, 1, 1, 3, 1, 1, 0, 0, 0, 0, 0],
    [0, 0, 0, 0, 0, 1, 0, 1, 0, 1, 0, 0, 0, 0, 0],
    [0, 0, 0, 0, 0, 1, 1, 1, 1, 1, 0, 0, 0, 0, 0],
    [0, 0, 0, 0, 0, 0, 0, 1, 0, 0, 0, 0, 0, 0, 0],
    [0, 0, 0, 0, 0, 0, 0, 1, 0, 0, 0, 0, 0, 0, 0],
    [0, 0, 0, 0, 0, 0, 0, 1, 0, 0, 0, 0, 0, 0, 0],
    [0, 0, 0, 0, 0, 0, 0, 1, 0, 0, 0, 0, 0, 0, 0],
    [0, 0, 0, 0, 0, 0, 0, 4, 0, 0, 0, 0, 0, 0, 0]
  ]
}
